##############
#p    ** *   #
#  # #*# #1# #
# x*  1  *** #
#  # # # #*# #
#f *   1  x *#
#  # # # # # #
#* *    1 *  #
##############
